NO assets/basic_wall.xpm
SO assets/basic_wall.xpm
WE assets/basic_wall.xpm
EA assets/basic_wall.xpm

F 220,0,0
C 225,30,0

10111
10001
10S01
10001
11111
