NO assets/basic_wall.xpm
SO assets/basic_wall.xpm
WE assets/basic_wall.xpm
EA assets/basic_wall.xpm

F 255,255,255
C 0,0,0

11111111111111111111
10000000000000000001
10000000000000000001
10000000000000000001
10000000000000000001
10000000000000000001
10000000000000000001
10000000000000000001
10000000000000000001
10000000000000000001
10000000000000000001
10000000000000000001
10000000000000000001
10000000000000000001
10000000000000000001
10000000000000000001
10000000000000000001
10000000000000000001
100000000000000000E1
11111111111111111111
