NO assets/matrix_NO.xpm
SO assets/matrix_SO.xpm
WE assets/matrix_WE.xpm
EA assets/matrix_EA.xpm

F 74,74,74
C 16,25,41

1111111111111
1000000000001
1000000000001
1001000001001
1000000000001
10000   00001
10000   00001
10000   00001
1000000000001
1001000001001
100000N000001
1000000000001
1111111111111