W1 assets/deepslate_tiles.xpm
W2 assets/cracked_deepslate_tiles.xpm

FL1 assets/basic_floor_128.xpm
FL2 assets/floor2_128.xpm
CA assets/carpet1_128.xpm

CE assets/ceiling1_128.xpm

LA assets/lamp1_128.xpm

        1111111111112221111111111
        1000000000120000000000001
        1011000001110000000000002
        1001000000000000000000002
111112211011000001110000000000001
100000000021000001110112110111111
11110111211111011100000010001
11110112111121011101020010002
11FFFFFF11F2F1011200000010N01
1FFCCCFFFFFFFFFF1100000020001
1FFCCCCCCCCCCCCC1100000010001
1FFCCCFFFFFFFFFF1101010010001
12FFFFF211F1F1F1111101112000111
1121F111 111F1F1 101111010001
11111111 1111121 111111111111

