W1 assets/basic_wall.xpm
W2 assets/matrix_WE.xpm

FL assets/matrix_SO_512.xpm
CE assets/matrix_NO_512.xpm

        1111111111111111111111111
        1000000000110000000000001
        1011000001110000000000002
        1001000000000000000000002
111111111011000001110000000000001
100000000011000001110111110111111
11110111111111011100000010001
11110111111111011101010010001
11000000110101011100000010N01
10000000000000001100000010001
10000000000000001101010010001
1100000111010101111101111000111
11110111 1110101 101111010001
11111111 1111111 111111111111

